Was gibt es zum Mittagessen? = What's for lunch?
Rinderbraten = roast beef
Kartoffeln = potato
lecker = yummy
Gemüse = vegetables
Suppe = soup
Nachtisch, Nachspeise = dessert
Obstsalat = fruit salad
(Speise-) Eis = ice cream
kleines rundes Milchbrötchen = scone
nehmen, mitnehmen = take
im Radio = on the radio
in der Mitte = in the middle
Was hättest du gern? / Was möchstest du? = What would you like?
Ich hätte gerne ... / Ich möchte ... = I'd like ...
Was möchtest du essen? = What would you like to eat?
heiß = hot
kalt = cold
trinken = drink
Getränk = drink
Sandwich / belegtes Brot = sandwich
Kuchen = cake
Sahne = cream
Marmelade = jam
Essen; Lebensmittel; Futter = food
Keks, Plätzchen = biscuit
Brot = bread
Käse = cheese
Fleisch = meat
Milch = milk
Wasser = water

