Heimatstadt = hometown
Deutschland = Germany
Guten Nachmittag = good afternoon

1 = one
2 = two
3 = three
4 = four
5 = five
6 = six
7 = seven
8 = eight
9 = nine
10 = ten
11 = eleven
12 = twelve
13 = thirteen
14 = fourteen

los gehts = here we go
hallo = hello
ich bin eine Robbe = I'm a seal
eine Robbe = a seal
ich heiße Silky = my name is Silky
ich bin zwei Jahre alt = I'm two years old
in England = in England
was = what
Fragen = questions
wie heißt du? = what's your name?
Junge = boy
wie alt bist du? = how old are you?
woher kommst du? = where are you from?
wo/woher = where
triff deine Mitschüler = meet your classmates
Karte = card/map
und = and
ich mag = I like
der/die/das = the
Farbe = colour
rot = red
blau = blue
Tipp = tip
los geht's nach England = let's go to England
zu, nach = to
gehen, fahren = go
kommen = come
sehen, besuchen = see
Heimatstadt = hometown
Stadt = town
willkommen in Plymouth = welcome to Plymouth
Fluss = river
Burg, Schloß = castle
Schwimmbecken = swimming pool
Turm = tower
Hügel = hill
Boot = boat
Meer = sea
Riesenrad = big wheel
groß = big
auf der Landkarte = on the map
Silky's Lied = Silky's song
ist es Montag? = is it Monday?

Montag = Monday
Dienstag = Tuesday
Mittwoch = Wednesday
Donnerstag = Thursday
Freitag = Friday
Samstag = Saturday
Sonntag = Sunday
jeden Tag = every day
großartig = great

